0	0	0	0	0	0	0	0	0	0	0	0	0	0	0	0	0	0	0	0	0	0	0	0	0	0	0
0	5	0	0	0	0	0	0	0	0	0	0	0	0	0	0	0	0	0	0	0	0	0	0	0	0	0
5	6	6	6	6	6	6	6	6	6	6	6	6	6	6	6	6	6	6	6	6	6	6	6	6	6	0
6	5	6	6	6	6	6	6	6	6	6	6	6	6	6	6	6	6	6	6	6	3	3	3	3	3	4
3	5	3	3	3	3	3	3	3	3	3	3	3	3	3	3	3	3	3	3	3	3	19	3	3	3	4
0	0	5	1	5	0	0	0	0	0	0	0	0	0	0	0	0	0	0	0	0	5	0	5	5	5	5
0	5	0	1	1	0	0	0	0	0	0	1	1	1	0	1	0	0	0	1	0	5	0	0	0	0	0
0	0	5	11	5	1	0	0	0	0	0	0	0	1	1	0	0	0	0	1	0	0	5	0	0	0	0
0	0	5	11	1	0	1	0	1	1	1	0	0	0	0	0	0	0	1	11	0	0	5	0	0	0	0
0	5	0	1	1	5	1	0	0	0	1	1	0	5	5	0	1	0	0	0	0	5	0	0	0	0	0
0	0	5	0	0	11	0	0	0	1	0	0	0	5	0	0	1	0	0	0	0	5	0	0	0	0	0
0	0	5	0	0	0	5	0	0	1	1	0	5	5	0	0	0	1	5	5	1	5	0	0	0	0	0
0	0	5	0	1	1	0	0	0	0	1	0	0	0	0	1	0	1	0	0	1	5	0	0	0	0	0
0	5	5	0	1	0	0	5	0	0	1	0	0	1	1	0	0	1	1	0	1	0	5	0	0	0	0
0	5	5	0	0	5	3	0	0	0	1	1	0	1	0	0	0	0	1	0	0	0	5	0	0	0	0
0	0	5	0	5	0	3	0	0	0	0	1	0	0	0	0	0	0	0	0	0	0	5	0	0	0	0
0	5	5	5	0	0	3	3	0	0	0	0	0	0	0	1	0	0	0	0	0	5	0	0	0	0	0
0	0	5	0	11	3	3	3	0	0	5	5	5	0	0	1	3	0	5	0	0	5	0	0	0	0	0
0	5	5	0	0	0	3	0	0	0	5	0	0	0	1	1	3	0	0	5	0	5	5	0	0	0	0
0	5	0	0	0	1	1	0	0	0	0	0	0	5	5	11	3	0	0	0	5	5	0	0	0	0	0
0	5	0	0	0	1	11	0	5	0	1	1	1	5	0	5	0	1	1	0	0	5	0	0	0	0	0
0	5	5	0	0	1	1	0	5	0	0	1	0	5	0	0	5	0	1	0	0	0	5	0	0	0	0
0	0	5	0	0	0	1	0	5	0	1	1	0	5	0	0	0	5	0	0	1	0	5	0	0	0	0
0	0	5	0	0	0	1	0	0	0	1	0	0	0	0	1	0	0	5	1	1	5	5	0	0	0	0
0	5	0	0	0	1	1	0	0	1	0	0	0	0	0	1	0	0	0	1	0	5	0	0	0	0	0
0	5	5	0	0	0	0	0	0	0	0	0	0	1	1	0	0	0	1	0	0	5	0	0	0	0	0
0	0	5	0	0	0	0	5	0	0	0	1	0	0	1	0	1	3	3	3	3	7	3	3	3	3	3
0	5	5	0	0	0	5	0	0	1	0	1	0	0	0	0	1	3	3	3	3	7	19	3	3	3	3
0	5	0	5	5	5	0	0	1	1	1	1	1	0	0	1	0	0	0	0	0	5	5	5	0	0	0
0	5	0	0	0	0	0	0	0	1	0	11	0	1	3	1	0	0	0	0	0	5	0	0	0	0	0
0	5	0	0	0	0	0	0	0	0	1	0	0	0	3	1	0	0	1	0	0	5	5	0	0	0	0
0	5	3	0	0	1	1	0	0	0	0	3	3	3	3	3	0	1	0	0	0	0	0	5	0	0	0
0	5	3	0	0	0	1	0	0	0	5	3	3	3	3	3	5	0	0	0	0	0	0	5	0	0	0
0	5	5	0	0	0	1	1	1	0	5	6	6	6	6	6	5	0	0	0	0	0	5	0	0	0	0
0	0	5	0	0	0	0	0	0	0	0	4	4	4	4	4	0	0	0	0	0	5	0	0	0	0	0
0	0	5	5	5	5	5	5	5	5	5	5	5	5	5	5	5	5	5	5	5	5	0	0	0	0	0