0	0	0	0	0	0	0	0	0	0	0	0	0	0	0	0	0	0	0	0	0	0	0	0	0	0	0	0	0	0	0	0	0	0	0	0	0	0	0	0	5
0	0	0	0	0	0	0	0	0	0	0	0	0	0	0	0	0	0	0	0	0	0	0	0	0	0	0	0	0	0	0	0	0	0	0	0	0	0	0	0	5
0	0	0	6	6	6	6	6	6	6	6	6	6	6	6	6	6	6	6	6	6	6	6	6	6	6	6	6	6	6	6	6	6	6	6	6	6	6	6	6	5
4	3	3	3	3	3	6	6	6	6	6	6	6	6	6	6	6	6	6	6	6	6	6	6	6	6	6	6	6	6	6	6	6	6	6	6	6	6	6	6	5
4	3	3	3	19	3	3	3	3	3	3	3	3	3	3	3	3	3	3	3	3	3	3	3	3	3	3	3	3	3	3	3	3	3	3	3	3	3	3	3	5
5	5	0	0	5	0	0	0	0	0	0	0	0	0	0	0	0	0	0	0	0	0	0	0	0	0	0	0	0	0	0	0	0	0	0	0	0	0	5	5	5
0	0	0	5	0	0	0	0	0	0	0	1	0	0	1	0	0	0	0	0	0	0	0	0	0	0	0	3	0	0	0	0	0	0	0	0	0	0	5	0	0
0	0	0	0	5	0	0	0	0	3	0	1	0	11	1	0	0	5	0	0	5	5	0	0	0	0	0	3	0	3	3	0	0	0	0	18	0	0	0	5	0
0	0	0	0	5	1	18	11	1	3	0	0	0	11	18	0	0	0	5	0	0	2	0	5	0	0	0	3	3	3	0	15	0	18	18	0	0	0	0	5	0
0	0	0	5	2	1	11	0	1	3	3	0	18	11	11	0	0	0	0	0	0	0	0	0	5	0	0	0	0	0	0	15	0	18	18	0	1	0	5	0	0
0	0	0	0	5	11	11	0	0	0	0	0	1	11	0	5	0	0	0	0	0	0	0	0	0	0	0	0	0	5	1	0	18	18	15	1	1	0	5	0	0
0	0	0	0	5	11	0	0	3	3	0	0	1	11	0	0	5	15	15	15	15	15	15	15	15	15	15	15	5	0	1	0	18	10	15	1	0	0	5	0	0
0	0	0	0	5	11	0	0	0	3	3	3	0	18	1	0	0	3	3	3	3	3	3	3	3	3	3	3	0	0	1	0	18	18	15	0	1	0	5	0	0
0	0	0	5	5	0	0	0	0	0	3	3	3	0	0	0	0	3	3	3	3	3	3	3	3	3	3	3	0	0	1	5	0	0	0	0	0	0	0	5	0
0	0	0	5	5	0	1	0	0	0	2	3	0	0	0	0	5	3	2	3	2	3	10	3	2	3	2	3	5	0	0	5	0	15	15	0	5	0	0	5	0
0	0	0	0	5	0	1	1	1	0	3	3	0	1	1	0	5	3	5	3	1	3	1	3	1	3	5	3	5	0	0	5	1	0	5	5	0	0	2	5	0
0	0	0	5	0	0	1	0	1	0	3	3	1	0	1	0	0	3	3	3	3	3	3	3	3	3	3	3	0	1	1	3	1	0	5	0	0	0	5	0	0
0	0	0	0	5	0	0	0	1	0	3	0	0	0	0	0	0	3	3	3	3	3	3	3	3	3	3	3	0	0	0	3	3	3	0	0	0	0	5	0	0
0	0	0	5	5	0	0	1	0	0	3	3	3	2	0	0	5	20	1	20	1	20	1	20	1	20	1	20	5	0	1	1	1	1	0	0	1	1	5	5	0
0	0	0	5	0	0	1	0	0	0	0	3	3	0	0	0	5	0	0	0	0	0	0	0	0	0	0	0	5	0	1	0	0	1	1	2	0	1	5	0	0
0	0	0	5	0	0	0	1	0	2	0	3	3	3	3	0	0	0	3	5	0	0	5	0	5	0	0	0	0	0	1	0	0	0	1	1	0	1	5	0	0
0	0	0	5	5	1	1	1	0	0	0	0	3	3	3	0	5	0	3	3	0	0	0	0	0	0	0	1	1	1	0	0	0	0	0	1	0	0	0	5	0
0	0	0	5	0	0	0	0	1	1	0	0	3	3	3	0	0	5	3	3	0	15	15	15	15	15	15	15	15	15	15	15	15	15	0	0	0	0	0	5	0
0	0	0	0	5	0	3	0	0	0	0	0	6	6	6	0	0	0	3	5	0	1	1	1	1	1	1	1	1	1	1	1	1	15	0	5	0	0	5	0	0
0	0	0	5	5	0	3	5	0	0	0	5	4	4	4	5	0	0	5	0	0	1	6	6	6	6	6	6	6	6	6	6	1	15	0	0	5	0	5	5	0
0	0	0	5	5	3	3	3	5	0	0	16	16	16	16	16	0	0	0	1	0	1	6	6	6	6	6	6	10	6	6	6	1	15	0	0	0	0	0	5	0
0	0	0	5	3	3	3	3	3	5	5	5	0	0	0	0	0	5	0	0	1	1	6	6	6	6	6	0	0	6	10	6	1	15	1	0	5	0	5	5	0
0	0	0	5	2	3	1	3	3	0	0	5	0	1	0	1	0	0	5	0	0	1	6	6	6	0	6	6	6	6	6	6	1	15	1	5	18	0	5	0	0
0	0	0	5	0	3	3	3	0	10	10	5	0	0	0	2	1	0	1	1	0	1	3	3	0	3	3	3	3	3	3	3	1	15	1	0	2	18	0	5	0
0	0	0	5	0	3	3	3	0	10	10	5	0	0	5	0	0	15	0	0	0	1	3	0	0	3	20	20	3	20	3	20	1	15	0	5	0	0	5	0	0
0	0	0	5	0	3	3	3	0	5	5	5	0	1	0	0	0	0	0	15	0	1	15	15	3	3	1	1	3	1	0	1	0	1	0	0	5	0	0	5	0
0	0	0	5	5	20	20	3	3	0	0	0	15	0	0	0	0	0	3	0	0	0	0	0	0	3	3	0	3	3	0	0	1	1	18	0	0	18	5	0	0
0	0	0	5	5	1	1	3	3	0	1	0	0	0	3	5	3	0	0	0	0	0	0	0	0	3	3	0	3	3	3	3	1	0	0	0	5	0	5	0	0
3	3	3	7	3	3	3	3	3	1	0	1	0	0	5	0	3	1	0	0	0	1	6	6	6	6	6	6	6	6	6	6	1	0	0	5	0	0	0	5	0
3	3	19	7	3	3	3	3	3	0	16	16	0	5	2	0	5	1	0	5	0	5	4	4	4	4	4	4	4	4	4	4	5	0	0	0	10	0	0	5	0
0	0	0	0	5	5	5	5	5	5	5	5	5	5	5	5	5	5	5	5	5	5	5	5	5	5	5	5	5	5	5	5	5	5	5	5	5	5	5	5	5