4	3	3	3	3	3	3	3	3	3	3	3	3	3	6	6	4
4	4	3	3	3	3	3	3	3	3	3	3	3	3	6	4	4
0	0	5	0	0	0	1	0	0	0	0	0	0	0	5	0	0
0	5	0	0	0	0	1	0	0	5	0	0	1	0	5	0	0
0	0	5	0	0	1	1	0	1	0	5	0	1	0	0	5	0
0	0	5	0	0	1	0	0	0	0	0	0	0	0	0	5	0
0	5	0	0	1	0	0	0	1	0	5	0	0	0	5	0	0
0	0	5	0	0	0	0	1	0	0	0	5	0	0	5	0	0
0	0	5	0	5	5	0	0	1	0	0	0	5	0	5	0	0
0	0	5	0	0	0	0	0	11	1	0	0	0	0	5	0	0
0	5	5	0	0	1	0	0	0	1	11	0	1	0	0	5	0
0	5	5	0	1	0	1	0	0	1	1	0	1	0	0	5	0
0	0	5	0	0	0	1	1	0	11	1	0	0	1	0	5	0
0	5	5	0	0	0	1	1	0	0	0	0	1	0	5	0	0
0	0	5	0	0	5	11	0	0	0	0	1	0	0	5	0	0
0	5	5	0	0	0	5	0	0	3	0	1	0	0	5	5	0
0	5	0	0	0	0	0	5	0	3	3	1	0	0	5	0	0
0	5	0	0	1	0	0	0	0	5	3	0	0	0	5	0	0
0	5	5	1	1	1	0	5	5	0	0	0	5	0	0	5	0
0	7	3	3	3	1	0	0	0	0	0	1	1	0	0	5	0
19	7	3	3	3	0	0	1	1	0	0	0	1	0	5	5	0
5	5	0	0	0	1	1	1	1	0	5	1	11	0	5	0	0
0	0	5	0	0	0	0	0	0	0	0	0	0	0	5	0	0
0	0	5	5	5	5	5	5	5	5	5	5	5	5	5	0	0